111111111111111111111111111111
100000000000000000000000000001
100000000000000000000000000001
100000000000000000000000000001
100000000000000000000000000001
100000000000000000001100000001

100000000000000000000000000001
100000000000000000000000000001
100C00000C00000000000000000001
100F00000F00000000000000000001
100000000000000000000000000001
100000E00000000000000000000001
1P0000000000000000000000000001
111111111111111111111111111111
