111111111111111111111111111111111
100000000000000000000000000000001
100000000000000000000000000000001
100000000000000000000000000000001
100000000000000000000000000000001
100000000000000P00000000000000001
100000000000000000000000000000001
100000000000000000000000000000001
100000000000000000000000000000001
100F00000F00000000000000000000001
100000000000000000000000000000001
100000000000000000000000000000001
100000000000000C00000000000000001
100000000000000000000000000000001
100000000000000000000000000000001
100000000000000000000000000000001
100000000000000E00000000000000001
111111111111111111111111111111111
