11111
1E001
10001
11101
11101
1PCC1
1E001
11111
10001
11111
