11111111111
1000100P001
10C010EC001
11111111111
