11111
100E1
100C1
100P1
11111
