11111
1E001
10001
11001
11101
1PCC1
10001
11101
10001
11111
