111111111111111111111111111111
100000000000000000000000000001
100F0F0000000000000000000000F1
100000000000000000000000000001
10000000F00F000000000F00000001
100000000000000000001100000001
10000000F0F0000000000000000001
1000000000000000000F0F00000001
1C0000000000000000000000000001
100F00000F00000000000000000001
1111111111111111111111111111F1
100000E00000000000000000F00001
1P0000000000000000000000F00001
111111111111111111111111111111
